C 135,206,250

F 92,92,92

NO textures/wall.xpm
SO textures/wall.xpm


WE        textures/wall.xpm
EA textures/wall.xpm



 111
1Ek0111111111111111  1111
1k00b0000000fbb02011110001
10000000000000001000000001
10000000000000001000000001
10000000000000002010010001  1
11111b0000000fbb10100100011101111111111
100011111111211110000000000000000c0c0001
1000t00e0e000000100111100010f00000000001
1000000000000000101  1011110011111111001
1000000000000000101  10t00101        101
1011t00e1e11t000121  10000101        101
1000000000000000101 100000101        101
10000000000000001001001t00101        101
10000000000000001001000000201       1201
10011110011111111001000000101        101
101    100000000001100000010111111111101
101   1f0000000000b201111110100000000001
121    111111111001101  10200001010010001
101             1011011110101001010010101
100111111111    1011000000101001000000101
10000000000b1   1011000000101001000000101
10000000000011111011111111101001111111001
 1111111000100000000000000101010000000001
        101111111110100000001000000t00t01
        10000000001011111111 11111111111
        1000000000001
 111111111111211111111111
10000000000000000000000001
10000000000000000000000001
10000000000000000000000001
10000000000000000000010001  1
111110000000000000000100011101111111111
1000100000000000000000000000000000000001
1000000000000000100110000000000000000001
1000000000000000101  1000000111111111001
1000000000000000001  10000101        101
1010000000000000001  10000101        101
1000000000000000001 100000101        101
10000000000000001001001000101        101
10000000000000001001000000001  111111101
100111100111111110000000000011111111 101
101    100000000000000000000000011111101
101   1f00000000000001111000000000000001
101    111111111001101  10000001010010001
101             1011011110101001010010101
100111111111    1011000000101001000000101
10000000000011111011000000101001000000101
10000000000000000000000001101001111111001
 1111111000000000000000000101010000000001
        100000000000000000001000000000001
        10000000001011111111 11111111111
        1000000000001
         11111111111
