C 135,206,250

F 92,92,92

NO textures/wall.xpm
SO textures/wall.xpm


WE        textures/wall.xpm
EA textures/wall.xpm

  1111  1111
11Ee01  1001
1000c1  1111
1c0001
111101
100b01
111111


