C 135,206,250

F 92,92,92

NO textures/wall.xpm
SO textures/wall.xpm


WE        textures/wall.xpm
EA textures/wall.xpm


  1111  1111
110001  1001
100001  1111
100001
111101
1E0001
111111


