C 173, 216, 230

F 100, 100, 100

NO textures/wall1.xpm
SO textures/wall1.xpm

TD textures/theme1/
WE        textures/wall1.xpm
EA textures/wall1.xpm



 111
1E0011176711111111111    111
1000b0000000000fbb02011110001
1000k000000000000001000100k01
10000000000000000001000100001
10000000000000000002000100001  9
11111b0000000000fbb100010000011k1111111111
100001176711111210000000000000000000c0c0009
1000t00eke000000100110000010f00000000000009
1000000000000000701  1f1110001176711100011
1000000000000000101  10000101        101
1011t00e1e11t000121  1k000101        101
1000000000000000101 100000101        101
10000000000000007001001t0010011111111001
100000000000000010010000002000f00k0f0001
100177100111111110k100000010011112111101
101    100000000001100000010100010100001
101   1f0000000000b200110110100000001001
121    111111111001101  10200001010010001
101             1010001100101000010010701
100171111111    1010000000107000000000601
10000000000b6   1010000000106000000000701
10000000000k61110001112111007001111101001
 1117111000100000000000000101010000000001
        101111161100100000001000000t00t01
        10000000001001161111121011111111
        100000000000000000000001
 111111101111116111111161111211011111111
10000000000000000000000000000000000000001
10000000000000000000000000000000000000001
1000000000000000000000000000k000000000001
10000000000000000000000000000000000010001  1
11111117671111111110000000000000000010000110111767111111
100000000000000000000000000000000000000000000000000000001
100000000000000000000000000000000011000000000000000000001
1000000000000000000000000000000001  100000001117671111001
1000000000000000000000beb000000001  10000701          101
1000000000000000000000eke000000001  10000601          107
1000000000000000000000beb000000001 100000701          106
10000000000000000000000000000000001000000001    11111 107
10000000000000000000000000000000001000000001   1000k11101
10011117671111111111110011767110000000000000111100001 101
101                   10000000000000000000000001011111001
101                  1f0000000000000011000000000000000001
101                   111111111000001  1000000111011100001
101                            100000110000700000000000701
700111117671111111111111111    100000000000600000000000601
6000000000000000000000000001111000000000000700000000000701
7000000000000000000000000000000000000000000100000011111001
 111111176711111111111100000000000000000000100000000000001
                       100000k00000000000001000000000k0001
                       10000000000011111111 1111111111111
                       1000000000001
                        11176711111
