C 173, 216, 230

F 101, 67, 33

NO textures/wall.xpm
SO textures/wall.xpm


WE        textures/wall.xpm
EA textures/wall.xpm



 111
1E0011111111111111111    111
1000b0000000000fbb02011110001
1000k000000000000001000100k01
10000000000000000001000100001
10000000000000000002000100001  1
11111b0000000000fbb100010000011k1111111111
100001111111111210000000000000000000c0c0001
1000t00eke000000100110000010f00000000000001
1000000000000000101  1f1110001111111100011
1000000000000000101  10000101        101
1011t00e1e11t000121  1k000101        101
1000000000000000101 100000101        101
10000000000000001001001t0010011111111001
100000000000000010010000002000f00k0f0001
100111100111111110k100000010011112111101
101    100000000001100000010100010100001
101   1f0000000000b200110110100000001001
121    111111111001101  10200001010010001
101             1010001100101000010010101
100111111111    1010000000101000000000101
10000000000b1   1010000000101000000000101
10000000000k11110001112111001001111101001
 1111111000100000000000000101010000000001
        101111111100100000001000000t00t01
        10000000001001111111121011111111
        100000000000000000000001
 111111101111111111111111111211011111111
10000000000000000000000000000000000000001
10000000000000000000000000000000000000001
1000000000000000000000000000k000000000001
10000000000000000000000000000000000010001  1
11111111111111111110000000000000000010000110111111111111
100000000000000000010000000000000000000000000000000000001
100000000000000000000000000000010011000000000000000000001
1000000000000000000000000000000101  100000001111111111001
1000000000000000000000beb000000001  10000101          101
1010000000000000000000eke000000001  10000101          101
1000000000000000000000beb000000001 100000101          101
10000000000000000000000000000001001001000101    11111 101
10000000000000000000000000000001001000000001   1000k11101
10011111111111111111110011111110000000000000111100001 101
101                   10000000000000000000000001011111001
101                  1f0000000000000011000000100000000001
101                   111111111001101  1000000111011100001
101                            101100110010100000000010101
100111111111111111111111111    101100000010100000000000101
1000000000000000000000000001111001100000010100000000000101
1000000000000000000000000000000000000000100100001011111001
 111111111111111111111100000000000000000010101110000000001
                       100000k00000000000001000000000k0001
                       10000000001011111111 1111111111111
                       1000000000001
                        11111111111
