C 135,206,250

F 92,92,92

NO textures/wall.xpm
SO textures/wall.xpm


WE        textures/wall.xpm
EA textures/wall.xpm

  1111  1111
11E0f1  1001
100001  1111
100001
111121
100001
111111


