C 135,206,250

F 92,92,92

NO textures/wall.xpm
SO textures/wall.xpm


WE        textures/wall.xpm
EA textures/wall.xpm

11111
1E00111111111111111  11111
1000200000000000201  10001
11111b0000000fbb1011110001111
10001111111111111000000000001
1000t00e0e00t0001011111100101
1000000000000000101  10111101
1000000000000000101  10t00101
1011t00e1e11t000121  10000101
1000000000000000101 100000101
10000000000000001011001t00101
10000000000000001011000000201
10111111011111111011000000101
101    1000000000011000000101
101   1f0000000000b2011111101
121   1111111111121101  10101
101             1011011110101
101111111111    1011000000101
1000000000001   1011000000101
1000000000001   1011111111101
1111111111111   1000000000101
                1000000000001
                1111111111111
