C 135,206,250

F 92,92,92
NO textures/north_wall.xpm
SO textures/south_wall.xpm


WE        textures/west_wall.xpm
EA textures/east_wall.xpm




 111111111111111111111111111111111111111
10000000000000000000000000000000000000001
10000000000000000000000000000000000000001
10000000000000000000000000f0k000000000001
10000000000000000000000000000000000010001
111111111111112111100000000000001000100001
1fffffffffffff0000000000000000002W00000001
1bbbbbbbbbbbbb0000000000000000001000000001
100000000000000000000000000000000000000001
100000000000000000000000000000000000000001
100000000000000000000000000000000000000001
100000000000000000000000000000000000000001
100000000000000000000000000000000000000001
100000000000000000000000000000000000000001
100000000000000000000000000000010011000001
1000000000000000000000000000000101  100001
1000000000000000000000beb000000001  100001
1012100000000000000000eke000000001  100001
1000000000000000000000beb000000001 1000001
100000000000000000000000000000010010010001
100000000000000000000000000000010010000001
111111111111111111111111111111111111111111



