C 135,206,250

F 92,92,92

NO textures/north_wall.xpm
SO textures/south_wall.xpm


WE        textures/west_wall.xpm
EA textures/east_wall.xpm

1111111
1100001
100W001
1100001
1111111
