C 135,206,250

F 92,92,92

NO textures/north_wall.xpm
SO textures/south_wall.xpm


WE        textures/west_wall.xpm
EA textures/east_wall.xpm

1111111111111111
1bbbbbbbbbbbbbbb1
1kkkkkkkkkkkkkkW1
1bbbbbbbbbbbbbbb1
1111111111111111
