C 135,206,250

F 92,92,92

NO north_wall.xpm
SO south_wall.xpm


WE        west_wall.xpm
EA east_wall.xpm

1111111
1100001
13W0001
1100001
1111111
