C 135,206,250

F 92,92,92

NO north_wall.xpm
SO south_wall.xpm


WE        west_wall.xpm
EA east_wall.xpm




 111
 101
11111111111111111111111111111111111111111111111
      10000000000000000000000000000000000000001
 1111113111111111111111111111111111111111111101
 1000000000000000000000000000000000000000000101
 100000000W000000000000000000000000000000000101
 1000000000000000000000000000000000000000000101
 1000000000000000000000111110000000000000111101
 10000110001100111000110001100011000110001  101
 10000110001100111000110001100011000110001  101
 1000000000000000000011111110000000000000111101
 1000000000000000000000000000000000000000000101
 1000000000000000000000000000000000000000000101
 1000000000000000000000000000000000000000000101
 1111111011111111111111111111111111111111111101
       1000000000000000000000000000000000000001
       1111111111111111111111111111111111111111
 1
 1
 1




