C 135,206,250

F 92,92,92
NO textures/north_wall.xpm
SO textures/south_wall.xpm


WE        textures/west_wall.xpm
EA textures/east_wall.xpm




 111
 101
111111 111111111111111111111111111111111111111
      10000000000000000000000000000000000000001
  111113111121111111111111111111111111111111101
 100t0000c0000000c000b000b00000t000000t00000101
 10000f000W00f00f000000000000000000000000000101
 1000000000000000000000f00e00000000000000000101
 100000t000000000000000111110000000000000111101
 10000110001100111000110001100011000110001  101
 10000110001100111000110001100011000110001  101
 1000000000000000000011111110000000000000111101
 1000000000000000000000000000000000000000000101
 1000000000000000000000000000000000000000000101
 1000000000000000000000000000000000000000000101
  111111011111111111111111111111111111111111101
       1000000000000000000000000000000000000001
       1111111111111111111111111111111111111111
 1
 1
 1




