C 173, 216, 230

F 100, 100, 100

NO textures/wall1.xpm
SO textures/wall1.xpm

TD textures/theme1/
WE        textures/wall1.xpm
EA textures/wall1.xpm


1111111111111111
1e000000000000101
1e0000000000002W1
1e0000000000001k1
1111111111111111
