C 173, 216, 230

F 100, 100, 100

NO textures/wall1.xpm
SO textures/wall1.xpm

TD textures/theme1/
WE        textures/wall1.xpm
EA textures/wall1.xpm


1111111111111111
1eeeeeeeeeeeee101
1eeeeeeeeeeeee2W1
1eeeeeeeeeeeee1k1
1111111111111111
