C 173, 216, 230

F 100, 100, 100

NO textures/wall1.xpm
SO textures/wall1.xpm

TD textures/theme1/
WE        textures/wall1.xpm
EA textures/wall1.xpm


 111
1E0011176711111111111    111
1000b0000000000fbb0201111bbb1
1000k00000000000000100b1c0k01
1000000000000000000100b1c0001
1000000000000000000200b1c0001  9
11111b0000000000fbb100b10000011k1111111111
1f00f1176711111210e30001000000000000c0c0ek9
100000teket00000100110000000000000000000ek9
1000000eee800000701  1f111f0f11767111f0f11
1000000eeet0000e101  1000e101        101
100600te6e700000131  1k000909        101
1k00000000t00000101 100e00101        101
100000000000000070k1e06t0010f11767111f01
1f0000000000000f1cc10000002000e00k000001
 11176711176711111111186811111176711111
