
C 173, 216, 230

F 101, 67, 33

NO textures/wall4.xpm
SO textures/wall4.xpm

TD textures/theme4/
WE        textures/wall4.xpm
EA textures/wall4.xpm



 1111111111111 11111 1    1111 1111111111111111718171111
1f0c00c00c00cf1c0c0c131  10000700000000000000000000000008
10000000000000100000801 100e00700f11f00000000000000000008
700007670000001c00007001008t001008  1000000f1117181711f01
600006 600000010000k800200te002006  60000001   771    101
7000076700000030117110k10000001008  10000007  1001    707
1000et0te0000080000000110000007001 1f0000006  1001    101
100000000000000000000000001100100f1f00000007  1001111 101
100000000000000f1771f00001 10020001000000bb1  10000k71707
10f1181181181111    100000910k1000000000000f111000007 101
701                 9f00001111700000000000000000011111f01
801                  100000000000000011000000000000000001
701                   117118117f00001  8000000000000000009
101                            100000110000000000000000001
10f111718817188171111111111    100000000000000000000000001
60000000000000000000000000f1771f00000000000000000000000009
1000000000000000000000000000000000000000000000000000000001
 1111171881718817111111f0000000000000000000f00000000000001
                       100000k00000000000001000000000k0009
                       10000000008011876781 9119119119119
                       100000N000001
                        11117711111
