
C 173, 216, 230

F 101, 67, 33

NO textures/wall4.xpm
SO textures/wall4.xpm

TD textures/theme4/
WE        textures/wall4.xpm
EA textures/wall4.xpm



 1111111111111 11111 1   11111 11111111111111117181711111
1f0c00c00c00cf1ccccc131 1100007e00e00000000000000000000e8
1000e000e0000e1000008011100e00700f11f0000000e00000000e008
7000076700000010000e7001008t001008  1000000f1017181711f01
6h00e6 60000001010ek80e200te002006  600000011e1771    101
700007670000003e117100k10000001008  10000007 110e1    707
1000et0te0000080000113110000007001 1f00000061 1001   1e01
1000000000000000000300000e1100100f1f000000f7111001111 101
10000000000000ef1771f00001 10020001000000bb11k10000k71707
10f1181181181111    10000e91ek1000e00000000f1c10000e7 101
701                 9f00001111700000000000000000011111f01
8e1                  100000000e00000e11e000000000000000011
701                   117118117f00078  8700000000000000009
1e1                            100000110000000000000000001
10f111718817188171111111111    100000000000b00000000000001
60000000e00000000000000000f1771f00000000000f00000000000009
1000000000000000000000000000000000000000000100000000000001
 1111e71881718817111111f0000000000000000000100000000000001
     1                 100000k00000000000001e00000e00k0009
                       10000000008he1876781 91191191191191
                       100000N0000011
                        11117711111
