
C 173, 216, 230

F 101, 67, 33

NO textures/wall4.xpm
SO textures/wall4.xpm

TD textures/theme4/
WE        textures/wall4.xpm
EA textures/wall4.xpm



 1111111111111 11111 1    1111 11111111111111117181711111
1f0c00c00c00cf1ccccc131  100007e00e00000000000000000000e8
1000e000e00000100000801 100e00700f11f0000000e00000000e008
7000076700000010000e7h01008t001008  1000000f1017181711f01
6000e6 6000000101hek80e200te002006  600000011e1771    101
700007670000003e117110k10000001008  10000007 110e1    707
1000et0te0000080000000110000007001 1f0000006  1001    101
1000000000000000000000000e1100100f1f000000f7  1001111 101
10000000000000ef1771f00001 10020001000000bb1  10000k71707
10f1181181181111    10000091ek1000e00000000f1110000e7 101
701                 9f00001111700000000000000000011111f01
8e1                  100000000e00000e11e00000000000000001
701                   117118117f00078  8700000000000000009
1e1                            100000110000000000000000001
10f111718817188171111111111    100000000000b00000000000001
60000000e00000000000000000f1771f00000000000f00000000000009
1000000000000000000000000000000000000000000100000000000001
 1111171881718817111111f0000000000000000000100000000000001
                       100000k00000000000001e00000e00k0009
                       10000000008he1876781191191191191191
                       100000N0000011
                        11117711111
