C 173, 216, 230

F 100, 100, 100

NO textures/wall1.xpm
SO textures/wall1.xpm

TD textures/theme1/
WE        textures/wall1.xpm
EA textures/wall1.xpm



 111
1E0011176711111111111    111
1000b0000000000fbb02011110h01
1000k000000000000001000100k01
1000000000000000000100010e001
10000000000000000002000100001  9
11111b0000000000fbb100010000011k1111111111
1000011767111112100000000e0000000000c0c0009
1000t00eke000000100110000010000000000000009
1000000000000000701  1f111e0f11767111f0011
1000000000000000101  10000101        101
1k11t00e6e00t000121  1k000101        101
100000h000000000101 1e0000101        101
10000000000000007001001t0010f11111111e01
100000000000000010010000002000f00k0f0h01
10e177100111111110k100000010011112111101
101    10000000000110000001010001e100001
101   1f000000000eb200110110100000001001
121    111111111001101  1e200001010010001
101             1010001100101000010010701
100171111111    1010000000107h00000000601
10000000000b6   1010000000106000000000701
10000000000k6111f0e1112111e07he1111101h01
 1117111000100000000000000101010000000001
        101111161100100000001000000t00t01
        10000000001001161111121e11111111
        100000000000000000000001
 1111111e1111116111111161111211e11111111
10000000000000000000000000000000000000001
10000000000000000000000000000000000000001
1000000000000000000000000000k000000000001
10000000000000000000000000000000000010001  1
1111111767111111111000000000000000001000011e111767111111
1000000000e0000000000000000000000000000000000000000000001
1000000000000000000000000000h0000011000000000000000000001
1000000000000000000000000000000001  1000000f1117671111e01
1000000000000000000000beb000000001  10000701          101
1000000000000000000000eke000000001  10000601          107
1000000000000000000000beb000000001 100000701          106
10000000000000000000000000000000001e00000001    11111 107
10000000000000000000000000000000001000000001   1000k11101
100111176711111111111100117671100000000000001111000e1 101
101                   10000000e00000000000000001011111e01
101                  1f0000000000000011000000000000000001
101                   111111111000001  1000000111011100001
101                            10000011e000700000000000701
700111117671111111111111111    100000000000600000000000601
600e0000000000000000000000011110000000000007000h0000000701
7000000000000000000000000000000000000000000100000011111e01
 111111176711111111111100000000000000000000100000000000001
                       100000k00000000000001000000000k00e1
                       10000e00000011111111 1111111111111
                       1000000000001
                        11176711111
