

C 173, 216, 230

F 101, 67, 33

NO textures/wall4.xpm
SO textures/wall4.xpm

TD textures/theme4/
WE        textures/wall4.xpm
EA textures/wall4.xpm

 111187678111111111111111781618711111111
10000k00000000000010000000000000000000001
1000000000000000001t0000000000000000000t1
1000000000000000001t00000000k0000000000t1
10000000000000000010000000000000000000001  1
11111311113111111110000000000000000000000111
100f00000000f000f001000000000000876780000001
10000000000000000000000000000000700070000001
10000000000000000000001110000000600060000008
10000000000000000000000e00000000700070000007
90100000000000000000000k00000000876780000006
10000000000000000000000e00000000000000000007
10000000000000000000000000000000000000000008
10000000000000000000000000000000000000000001
1001111111868111111100001991111187678111111
1000k000000000000001000100k01
10000000000000000001000100001
10000000000000000002000100001  9
11111b0000000000f1110001000001101111911111
10000116861111121000000000000000000000000f1
1000t00eke000000100110000090f000000000000f1
8000000000000000601  111210000000000100011
7000000000000000101 1000010000000001 101
6000t00e0e00t000121 9000010011111111 101
7000000000000000101 1000c101  100007 101
800000000000000060010t00k121  1k00061001
100000000000000010010000c101 10000070001
100161100116861190k1000001001001t0011101
101    100000000001100000100100000020001
101   9f0000000000030111110k100000018001
131    1119119110011000000010000000160001
107             10100000000b0001101180101
100118161811    101000111001001  10200101
70000000000b1   707001   1010001100100101
70000000000k11110001111118001001767101001
 1111811000100000000000000101010000000001
        801117111100000000001000000t00t01
        10000000000001111811131011118111
        800000000000000000000009
 118681101111711111111111811211011118111
10000000000000000000010000000000000000001
70000000000000001113100000000000000000007
70000000000000000000800110000010000000007
1000000c0c0000000000701  131110f000010001  6
11111211111211110000801  1000010000010000110111718171111
100000000000001c0000131  10000700000000000000000000000008
10000000000000100000801 100000700011000000000000000000008
700007670000001c00007001001t001008  100000001117181711001
600006 6000000100000800200t0002006  60000001   771    101
7000076700000030117110k10000001008  10000007  1001    707
1000000000000010000000110000007001 100000006  1001    101
10000000000000000000000200110010001001000007  1001111 101
10000000000000001771000101 10020001000000001  10000k71707
1001181181181111    101000910010000000000000111000007 101
701                 9001001111700000000000000000011111001
801                  100000000000000011000000000000000001
701                   117118117001101  8000000000000000009
101                            101100110000000000000000001
100111718817188171111111111    101100000000000000000000001
6000000000000000000000000001771001100000000000000000000009
1000000000000000000000000000000000000000000b00000000000001
 111117188171881711111100000000000000000000b00000000000001
                       100000k00000000000001000000000k0009
                       10000000001011876781 9119119119119
                       100000N000001
                        11117711111
